#
# 0 D room1.txt 1 key0
#
# K key0
#
WWWW0WWWWW
W      M W
W  S     W
WWWWW    W
W   W    W
W   W  WWW
W  H   B W
W        W
W    K   W
WWWWWWWWWW
