#
# 1 D room0.txt 0 key0
# 2 D room2.txt 3
#
WWWW2WWWWW
W      T W
W   A    W
WWWWW    W
W  MW   SW
W GWWW WWW
W  W     W
W  WW BM W
W        W
WWWW1WWWWW