#
# 5 D room2.txt 4
# 6 D room4.txt 7
#
WWWWWWWW6W
WMK   W  W
W  G  W  W
WWW   W  W
W  T    SW
W  WWW WWW
W  W M   W
W  WW  Z W
W  B     W
WWWWWW5WWW