#
# 3 D room1.txt 2
# 4 D room3.txt 5
#
WW4WWWWWWW
W B    Z W
WA    WW W
WWWWW    W
W  AW   SW
W  WWW  WW
WT   M   W
W  WWW   3
W  B     W
WWWWWWWWWW