# 0 D room1.txt 1 key0
# 7 D room1.txt 2
# K key0
WWWW0WWWWW
W        W
W  S     W
WWWWW    W
W   W    W
W   W  WWW
W  H     W
W        W
W    K   7
WWWWWWWWWW
